{
    "'": {
      "a": "á",
      "e": "é",
      "i": "í",
      "o": "ó",
      "u": "ú",
      "A": "Á",
      "E": "É",
      "I": "Í",
      "O": "Ó",
      "U": "Ú"
    },
    "`": {
      "a": "à",
      "e": "è",
      "i": "ì",
      "o": "ò",
      "u": "ù",
      "A": "À",
      "E": "È",
      "I": "Ì",
      "O": "Ò",
      "U": "Ù"
    },
    "^": {
      "a": "â",
      "e": "ê",
      "i": "î",
      "o": "ô",
      "u": "û",
      "A": "Â",
      "E": "Ê",
      "I": "Î",
      "O": "Ô",
      "U": "Û"
    },
    "\"": {
      "a": "ä",
      "e": "ë",
      "i": "ï",
      "o": "ö",
      "u": "ü",
      "A": "Ä",
      "E": "Ë",
      "I": "Ï",
      "O": "Ö",
      "U": "Ü"
    },
    ",": {
      "c": "ç",
      "C": "Ç"
    }
  }
  